######
#    ####
# #$ $  #
# #  #  #
#  $ # ##
## # . #
 # @ ..#
 #######
