    #####
    #   #
    #$  #
  ###  $##
  #  $   #
### # ## #   ####
#   # ## ##### .#
# @             .#
##### ### # ##  .#
    #     ########
    #######
