  #####
 ##   ##
##  $  ##
#  #$#  #
# . # . #
# . @ $ #
#       #
#########
