########
#      #
#  $ . #
#  @   #
#      #
########
